A 7
#######
#     #
# $.  #
# $.  #
# $.  #
#  @  #
#######
