A 9
#########
#       #
#  @    #
## $    #
#  .    #
# $$    #
# ..    #
#       #
#########
