A 9
 #######
 #  .  #
## b## #
# .$+# #
#  $*# #
### c d#
  #  ###
  #@ #
  ####

b 8
 ######
 #   .#
## ## #
# ..$ ##
#   #$ #
# .$ $ #
##  ####
 ####

c 8
 ####
 #  ####
 #$  $ #
 # . . #
##$##. #
#  .# ##
#  $  #
########

d 7
 #####
 #   #
##.$ #
# $$ #
# . .#
#   ##
#####
