A 5
#####
#   #
# $.#
# @ #
#####
