A 9
##########
#@ $. B C#
#   $. D #
#        #
#        #
#        #
#        #
#        #
##########

b 9
#######
#     #
#  $  #
#  .  #
# $   #
#     #
#     #
#   # #
#######

c 8
#######
#     #
#  $  #
#   $ #
# .   #
#     #
# #   #
#######

d 7
 #####
 #   #
##.$ #
# $$ #
# . .#
#   ##
#####
