A 9
 ####
 #  ####
 #b  c #
 # . . #
##$##. #
# @#. ##
# $   ##
####  #
   ####

b 8
 ####
 #  ####
 #$  $ #
 # . . #
##$##. #
#  .# ##
#  $  #
########

c 8
 #####
 #   #
 # #$#
 # $ ###
## #$  #
#  . . #
#  .#$ #
###  .##
