A 7
#######
#     #
#@ $. #
#  b. #
#     #
#     #
#######

B 7
#######
#     #
# $.  #
#  c. #
#     #
#     #
#######

C 5
#####
#   #
# $ #
# . #
#####
