A 9
##########
#@ $ . B #
#  $ . C #
#  $ . D #
#      E #
#        #
#        #
#        #
##########

b 9
#######
# $   #
#  .  #
#  .  #
#   # #
#     #
#     #
#     #
#######

c 8
#   $ #
# .   #
#  $  #
# #   #
#     #
#     #
#     #
#######

d 8
#  $$ #
#  .. #
#  $  #
#  .  #
#     #
#     #
#     #
#######

e 8
#######
#     #
#  $  #
#  .  #
#     #
#     #
#     #
#######
