A 7
########
#@     #
# $    #
# .    #
# #$   #
#  .   #
########
