A 9
#########
#       #
#       #
#    .  #
#   B@  #
#       #
#       #
#       #
#########

B 9
#########
#       #
#       #
#       #
#   C   #
#       #
#       #
#       #
#########

C 9
#########
#       #
#       #
#       #
#   D   #
#       #
#       #
#       #
#########

D 9
#########
#       #
#       #
#       #
#   E   #
#       #
#       #
#       #
#########

E 9
#########
#       #
#       #
#       #
#   $   #
#       #
#       #
#       #
#########
