A 6
######
#@   #
# $$ #
# .. #
#    #
######
