B 7
#######
#  .  #
#  $  #
## #  #
# @ $ #
#  .  #
#######
