A 8
########
#      #
#@ $  .#
#   $. #
#   b. #
#      #
#      #
########

B 7
#######
#     #
# $   #
# .   #
#   c.#
#     #
#######

C 7
#######
#     #
# $   #
# .   #
#   $ #
#   . #
#######
