A 9
 ######
 # . b#
## #c###
# . .$ #
# d. e #
# #$ ###
#. $$@#
###   #
  ####

b 8
  ####
  #  #
###  #
#  * #
#. . #
# $.$##
##$*$ #
 ###  #

c 8
 ####
 #  ###
 # $  #
 # $..#
### $#.#
#. $.$ #
# #   ##
#   ###

d 8
 #######
 #     #
# # .  #
#   $  #
## #*  #
 #$#.  #
 #  $*##
 ### . #

e 8
   ####
####  .#
# $.$# #
#$#.  .#
#.   # #
#  $ $ #
#  #####
####
