A 6
######
#    #
# $. #
#  @ #
# $. #
######
