A 9
#########
#       #
#@ $  . #
#  $  . #
#  $  . #
#  b    #
#     . #
#       #
#########

B 8
########
#      #
# $  . #
#   $. #
#   c. #
#      #
#      #
########

C 7
#######
#     #
# $   #
# .   #
#   d.#
#     #
#######

D 7
#######
#     #
# $   #
# .   #
#   $ #
#   . #
#######
