A 9
##########
#@ $ . B #
#  $ . C #
#  $ . D #
#      E #
#        #
#        #
#        #
##########

b 8
#######
#     #
#  $  #
#  .  #
#     #
#     #
#     #
#######

c 8
#######
#     #
#  $  #
#  .  #
#     #
#     #
#     #
#######

d 8
#######
#     #
#  $  #
#  .  #
#     #
#     #
#     #
#######

e 8
#######
#     #
#  $  #
#  .  #
#     #
#     #
#     #
#######
