A 7
##########
#  ..    #
# b  c   #
#   @    #
#        #
#        #
##########

B 6
######
#  . #
#  $ #
# @  #
#    #
######

C 6
######
# .  #
# $  #
#  @ #
#    #
######
