A 9
 ####
 #  ####
 #b  c #
 # . . #
##$##. #
# @#. ##
# $   ##
####  #
   ####

b 8
#######
#  c  #
#  $  #
#  .  #
#     #
#     #
#     #
#######

c 8
 #####
 # d #
 # #$#
 # $ ###
## #$  #
#  . . #
#  .#$ #
###  .##

d 7
#######
#     #
#  $  #
#  .  #
#     #
#  @  #
#######
