D 8
#       
#       
#       
........
#       
#       
#       
#       

C 8
########
  $$$ D#
       #
  ######
        
#      #
########
########

B 8
########
########
##C$$   
######  
######  
######  
######  
###### #

A 8
########
#     @#
#$######
# ###B##
# ###$##
  ###$##
      ##
      ##

