B 5
## ##
#   #
. $ #
# : #
#####

A 5
  @  
     
##B##
#####
#####