B 7
#######
#     #
# .   #
# $    
#     #
#     #
#######
C 5
#####
#.  #
#    
# $ #
##$##
D 4
####
#: #
#  $
####
A 10
##########
#@       #
#b$#######
#        #
#        #
#     c  #
#        #
#        #
#   d    #
##########
