B 6
######
#    #
# .  #
# $   
#    #
######
C 5
#####
#   #
    
# . #
#####
A 10
##########
#    #   #
# # $#   #
# #  #   #
# #b #   #
# #  #  c#
# $  #   #
# #  .   #
#@#  #  :#
##########
