B 5
#####
#    
# $ #
#   #
#####
A 8
########
#@     #
#  $   #
#  .   #
#    b #
#      #
#      #
########