B 4
####
#  #
#   
# ##

A 7
#######
#B   @#
# #####
# #####
# #####
#:#####
#######
