B 5
#####
#@. #
#    
# $ #
#####
C 5
#####
#: ##
#    
#  $ 
#####
A 9
#########
#      .#
###$    #
##      #
##  b   #
##      #
#c      #
##      #
#########