B 6
######
#    #
##.# #
#     
#    #
######
C 5
#####
#.  #
#   
#   $
#####
A 9
#########
#@      #
#  $    #
#       #
#       #
#     c #
#       #
#b :    #
#########
