B 5
#####
# . #
#    
# $ #
#####
C 5
#####
#.  #
 $  
#   #
#####
A 8
########
#@     #
# $    #
#      #
# b  c #
#      #
#      #
########
