C 8
########
#   .  #
# ##$# #
#  $   #
# ## # #
# . @  #
#      #
########
