A 7
#########
#  ...  #
#  $$ b #
#   @   #
#       #
#       #
#########

B 5
#####
# . #
# $ #
# @ #
#####
